221222122221222111-
121212121121212111-
121212121121212111-
121212121121212111-
121212121121212111-
121212121121212111-
122212221122212222-
111111111111111111