221222122221222112-
121212121121212112-
121212121121212112-
121212121121212112-
121212121121212112-
121212121121212112-
122212221122212222-
111111111111111111